########################################################################################################
e..#.#...#..##..#.#...#..##..#.#...#..##..#.#...#..##..#.#...#..##..#.#...#..##..#.#...#..##..#.#...#..#
##.#.##.##.####.#.##.##.####.#.##.##.####.#.##.##.####.#.##.##.####.#.##.##.####.#.##.##.####.#.##.##.##
#....#..#...##....#..#...##....#..#...##....#..#...##....#..#...##....#..#...##....#..#...##....#..#...#
###.##.##.######.##.##.######.##.##.######.##.##.######.##.##.######.##.##.######.##.##.######.##.##.###
#...........##...........##...........##...........##...........##...........##...........##...........#
#####.###.########.###.########.###.########.###.########.###.########.###.########.###.########.###.###
#...........##...........##...........##...........##...........##...........##...........##...........x
########################################################################################################
########################################################################################################
#..#.#...#..##..#.#...#..##..#.#...#..##..#.#...#..##..#.#...#..##..#.#...#..##..#.#...#..##..#.#...#..#
##.#.##.##.####.#.##.##.####.#.##.##.####.#.##.##.####.#.##.##.####.#.##.##.####.#.##.##.####.#.##.##.##
#....#..#...##....#..#...##....#..#...##....#..#...##....#..#...##....#..#...##....#..#...##....#..#...#
###.##.##.######.##.##.######.##.##.######.##.##.######.##.##.######.##.##.######.##.##.######.##.##.###
#...........##...........##...........##...........##...........##...........##...........##...........#
#####.###.########.###.########.###.########.###.########.###.########.###.########.###.########.###.###
#...........##...........##...........##...........##...........##...........##...........##...........#
########################################################################################################
########################################################################################################
#..#.#...#..##..#.#...#..##..#.#...#..##..#.#...#..##..#.#...#..##..#.#...#..##..#.#...#..##..#.#...#..#
##.#.##.##.####.#.##.##.####.#.##.##.####.#.##.##.####.#.##.##.####.#.##.##.####.#.##.##.####.#.##.##.##
#....#..#...##....#..#...##....#..#...##....#..#...##....#..#...##....#..#...##....#..#...##....#..#...#
###.##.##.######.##.##.######.##.##.######.##.##.######.##.##.######.##.##.######.##.##.######.##.##.###
#...........##...........##...........##...........##...........##...........##...........##...........#
#####.###.########.###.########.###.########.###.########.###.########.###.########.###.########.###.###
#...........##...........##...........##...........##...........##...........##...........##...........#
########################################################################################################
########################################################################################################
#..#.#...#..##..#.#...#..##..#.#...#..##..#.#...#..##..#.#...#..##..#.#...#..##..#.#...#..##..#.#...#..#
##.#.##.##.####.#.##.##.####.#.##.##.####.#.##.##.####.#.##.##.####.#.##.##.####.#.##.##.####.#.##.##.##
#....#..#...##....#..#...##....#..#...##....#..#...##....#..#...##....#..#...##....#..#...##....#..#...#
###.##.##.######.##.##.######.##.##.######.##.##.######.##.##.######.##.##.######.##.##.######.##.##.###
#...........##...........##...........##...........##...........##...........##...........##...........#
#####.###.########.###.########.###.########.###.########.###.########.###.########.###.########.###.###
#...........##...........##...........##...........##...........##...........##...........##...........#
########################################################################################################
########################################################################################################
#..#.#...#..##..#.#...#..##..#.#...#..##..#.#...#..##..#.#...#..##..#.#...#..##..#.#...#..##..#.#...#..#
##.#.##.##.####.#.##.##.####.#.##.##.####.#.##.##.####.#.##.##.####.#.##.##.####.#.##.##.####.#.##.##.##
#....#..#...##....#..#...##....#..#...##....#..#...##....#..#...##....#..#...##....#..#...##....#..#...#
###.##.##.######.##.##.######.##.##.######.##.##.######.##.##.######.##.##.######.##.##.######.##.##.###
#...........##...........##...........##...........##...........##...........##...........##...........#
#####.###.########.###.########.###.########.###.########.###.########.###.########.###.########.###.###
#...........##...........##...........##...........##...........##...........##...........##...........#
########################################################################################################
########################################################################################################
#..#.#...#..##..#.#...#..##..#.#...#..##..#.#...#..##..#.#...#..##..#.#...#..##..#.#...#..##..#.#...#..#
##.#.##.##.####.#.##.##.####.#.##.##.####.#.##.##.####.#.##.##.####.#.##.##.####.#.##.##.####.#.##.##.##
#....#..#...##....#..#...##....#..#...##....#..#...##....#..#...##....#..#...##....#..#...##....#..#...#
###.##.##.######.##.##.######.##.##.######.##.##.######.##.##.######.##.##.######.##.##.######.##.##.###
#...........##...........##...........##...........##...........##...........##...........##...........#
#####.###.########.###.########.###.########.###.########.###.########.###.########.###.########.###.###
#...........##...........##...........##...........##...........##...........##...........##...........#
########################################################################################################
########################################################################################################
#..#.#...#..##..#.#...#..##..#.#...#..##..#.#...#..##..#.#...#..##..#.#...#..##..#.#...#..##..#.#...#..#
##.#.##.##.####.#.##.##.####.#.##.##.####.#.##.##.####.#.##.##.####.#.##.##.####.#.##.##.####.#.##.##.##
#....#..#...##....#..#...##....#..#...##....#..#...##....#..#...##....#..#...##....#..#...##....#..#...#
###.##.##.######.##.##.######.##.##.######.##.##.######.##.##.######.##.##.######.##.##.######.##.##.###
#...........##...........##...........##...........##...........##...........##...........##...........#
#####.###.########.###.########.###.########.###.########.###.########.###.########.###.########.###.###
#...........##...........##...........##...........##...........##...........##...........##...........#
########################################################################################################
########################################################################################################
#..#.#...#..##..#.#...#..##..#.#...#..##..#.#...#..##..#.#...#..##..#.#...#..##..#.#...#..##..#.#...#..#
##.#.##.##.####.#.##.##.####.#.##.##.####.#.##.##.####.#.##.##.####.#.##.##.####.#.##.##.####.#.##.##.##
#....#..#...##....#..#...##....#..#...##....#..#...##....#..#...##....#..#...##....#..#...##....#..#...#
###.##.##.######.##.##.######.##.##.######.##.##.######.##.##.######.##.##.######.##.##.######.##.##.###
#...........##...........##...........##...........##...........##...........##...........##...........#
#####.###.########.###.########.###.########.###.########.###.########.###.########.###.########.###.###
#...........##...........##...........##...........##...........##...........##...........##...........#
########################################################################################################
########################################################################################################
#..#.#...#..##..#.#...#..##..#.#...#..##..#.#...#..##..#.#...#..##..#.#...#..##..#.#...#..##..#.#...#..#
##.#.##.##.####.#.##.##.####.#.##.##.####.#.##.##.####.#.##.##.####.#.##.##.####.#.##.##.####.#.##.##.##
#....#..#...##....#..#...##....#..#...##....#..#...##....#..#...##....#..#...##....#..#...##....#..#...#
###.##.##.######.##.##.######.##.##.######.##.##.######.##.##.######.##.##.######.##.##.######.##.##.###
#...........##...........##...........##...........##...........##...........##...........##...........#
#####.###.########.###.########.###.########.###.########.###.########.###.########.###.########.###.###
#...........##...........##...........##...........##...........##...........##...........##...........#
########################################################################################################
########################################################################################################
#..#.#...#..##..#.#...#..##..#.#...#..##..#.#...#..##..#.#...#..##..#.#...#..##..#.#...#..##..#.#...#..#
##.#.##.##.####.#.##.##.####.#.##.##.####.#.##.##.####.#.##.##.####.#.##.##.####.#.##.##.####.#.##.##.##
#....#..#...##....#..#...##....#..#...##....#..#...##....#..#...##....#..#...##....#..#...##....#..#...#
###.##.##.######.##.##.######.##.##.######.##.##.######.##.##.######.##.##.######.##.##.######.##.##.###
#...........##...........##...........##...........##...........##...........##...........##...........#
#####.###.########.###.########.###.########.###.########.###.########.###.########.###.########.###.###
#...........##...........##...........##...........##...........##...........##...........##...........#
########################################################################################################
########################################################################################################
#..#.#...#..##..#.#...#..##..#.#...#..##..#.#...#..##..#.#...#..##..#.#...#..##..#.#...#..##..#.#...#..#
##.#.##.##.####.#.##.##.####.#.##.##.####.#.##.##.####.#.##.##.####.#.##.##.####.#.##.##.####.#.##.##.##
#....#..#...##....#..#...##....#..#...##....#..#...##....#..#...##....#..#...##....#..#...##....#..#...#
###.##.##.######.##.##.######.##.##.######.##.##.######.##.##.######.##.##.######.##.##.######.##.##.###
#...........##...........##...........##...........##...........##...........##...........##...........#
#####.###.########.###.########.###.########.###.########.###.########.###.########.###.########.###.###
#...........##...........##...........##...........##...........##...........##...........##...........#
########################################################################################################